10
*.*.**.*.*.*.*.**.
*.*.**.*.*.*.*.**.
*.****.*.*.*.*.***
***.**.*.***.*.**.
*.*.**.*.*.*.*.**.
***.**.*.***.*.**.
*........***.*.**.
*.*.***.****.*.**.
***.**.*.*.*.*.**.
***.**.*.***.*.***